Completed,Week,Day of Week,Projected Winner,Projected Winner's Rank,Projected Winner's Percentage Difference,Rank Difference,Projected Winner Futures Difference,Away Team,Away Rank,Away Percentage,Away Futures NJ,Away-Home Futures NJ difference,Home Team,Home Rank,Home Percentage,Home Futures NJ,Home-Away Futures NJ difference,Game URL
true,1,,Kansas City Chiefs,2,,9,-900,Detroit Lions,6,NaN,1600,900,Kansas City Chiefs,0,NaN,700,-900,https://www.espn.com/nfl/game?gameId=401547353
true,1,,Atlanta Falcons,17,,12,-5500,Carolina Panthers,28,NaN,10000,5500,Atlanta Falcons,13,NaN,4500,-5500,https://www.espn.com/nfl/game?gameId=401547403
true,1,,Cleveland Browns,10,,2,400,Cincinnati Bengals,5,NaN,1400,-400,Cleveland Browns,8,NaN,1800,400,https://www.espn.com/nfl/game?gameId=401547397
true,1,,Indianapolis Colts,30,,18,12800,Jacksonville Jaguars,11,NaN,2200,-12800,Indianapolis Colts,29,NaN,15000,12800,https://www.espn.com/nfl/game?gameId=401547404
true,1,,Minnesota Vikings,15,,13,-2000,Tampa Bay Buccaneers,24,NaN,8000,2000,Minnesota Vikings,20,NaN,6000,-2000,https://www.espn.com/nfl/game?gameId=401547398
true,1,,New Orleans Saints,19,,5,-7000,Tennessee Titans,27,NaN,10000,7000,New Orleans Saints,12,NaN,3000,-7000,https://www.espn.com/nfl/game?gameId=401547399
true,1,,Pittsburgh Steelers,23,,20,6300,San Francisco 49ers,2,NaN,700,-6300,Pittsburgh Steelers,23,NaN,7000,6300,https://www.espn.com/nfl/game?gameId=401547405
true,1,,Washington Commanders,25,,7,-22000,Arizona Cardinals,30,NaN,30000,22000,Washington Commanders,25,NaN,8000,-22000,https://www.espn.com/nfl/game?gameId=401547406
true,1,,Baltimore Ravens,7,,24,-28200,Houston Texans,31,NaN,30000,28200,Baltimore Ravens,9,NaN,1800,-28200,https://www.espn.com/nfl/game?gameId=401547396
true,1,,Chicago Bears,26,,10,5500,Green Bay Packers,14,NaN,4500,-5500,Chicago Bears,26,NaN,10000,5500,https://www.espn.com/nfl/game?gameId=401547407
true,1,,Denver Broncos,14,,8,0,Las Vegas Raiders,18,NaN,6000,0,Denver Broncos,17,NaN,6000,0,https://www.espn.com/nfl/game?gameId=401547400
true,1,,New England Patriots,18,,13,6300,Philadelphia Eagles,1,NaN,700,-6300,New England Patriots,21,NaN,7000,6300,https://www.espn.com/nfl/game?gameId=401547402
true,1,,Los Angeles Chargers,9,,3,600,Miami Dolphins,7,NaN,1600,-600,Los Angeles Chargers,10,NaN,2200,600,https://www.espn.com/nfl/game?gameId=401547401
true,1,,Seattle Seahawks,21,,1,-1000,Los Angeles Rams,19,NaN,6000,1000,Seattle Seahawks,16,NaN,5000,-1000,https://www.espn.com/nfl/game?gameId=401547408
true,1,,New York Giants,27,,26,5900,Dallas Cowboys,4,NaN,1100,-5900,New York Giants,22,NaN,7000,5900,https://www.espn.com/nfl/game?gameId=401547409
true,1,,New York Jets,13,,9,4000,Buffalo Bills,3,NaN,1000,-4000,New York Jets,15,NaN,5000,4000,https://www.espn.com/nfl/game?gameId=401547352
true,2,,Philadelphia Eagles,5,,10,-5300,Minnesota Vikings,20,NaN,6000,5300,Philadelphia Eagles,1,NaN,700,-5300,https://www.espn.com/nfl/game?gameId=401547410
false,2,Sunday,Buffalo Bills,4,43,18,-5000,Las Vegas Raiders,18,28.4,6000,5000,Buffalo Bills,3,71.4,1000,-5000,https://www.espn.com/nfl/game?gameId=401547411
false,2,Sunday,Dallas Cowboys,1,36.3,12,-3900,New York Jets,15,31.7,5000,3900,Dallas Cowboys,4,68,1100,-3900,https://www.espn.com/nfl/game?gameId=401547415
false,2,Sunday,Denver Broncos,14,33.1,11,-2000,Washington Commanders,25,33.3,8000,2000,Denver Broncos,17,66.4,6000,-2000,https://www.espn.com/nfl/game?gameId=401547416
false,2,Sunday,San Francisco 49ers,3,31.3,17,-5300,San Francisco 49ers,2,65.5,700,-5300,Los Angeles Rams,19,34.2,6000,5300,https://www.espn.com/nfl/game?gameId=401547422
false,2,Sunday,Detroit Lions,11,29.6,10,-3400,Seattle Seahawks,16,35.1,5000,3400,Detroit Lions,6,64.7,1600,-3400,https://www.espn.com/nfl/game?gameId=401547418
false,2,Sunday,New York Giants,27,29.6,5,-23000,New York Giants,22,64.7,7000,-23000,Arizona Cardinals,30,35.1,30000,23000,https://www.espn.com/nfl/game?gameId=401547421
false,2,Sunday,Los Angeles Chargers,9,25.9,15,-7800,Los Angeles Chargers,10,62.8,2200,-7800,Tennessee Titans,27,36.9,10000,7800,https://www.espn.com/nfl/game?gameId=401547414
false,2,Sunday,Miami Dolphins,6,23.5,12,-5400,Miami Dolphins,7,61.6,1600,-5400,New England Patriots,21,38.1,7000,5400,https://www.espn.com/nfl/game?gameId=401547423
false,2,Monday,New Orleans Saints,19,23.1,10,-7000,New Orleans Saints,12,61.4,3000,-7000,Carolina Panthers,28,38.3,10000,7000,https://www.espn.com/nfl/game?gameId=401547425
false,2,Sunday,Kansas City Chiefs,2,22.9,10,-1500,Kansas City Chiefs,0,61.3,700,-1500,Jacksonville Jaguars,11,38.4,2200,1500,https://www.espn.com/nfl/game?gameId=401547413
false,2,Monday,Cleveland Browns,10,19.5,13,-5200,Cleveland Browns,8,59.6,1800,-5200,Pittsburgh Steelers,23,40.1,7000,5200,https://www.espn.com/nfl/game?gameId=401547424
false,2,Sunday,Houston Texans,31,6.4,1,15000,Indianapolis Colts,29,46.6,15000,-15000,Houston Texans,31,53,30000,15000,https://www.espn.com/nfl/game?gameId=401547419
false,2,Sunday,Tampa Bay Buccaneers,28,4.6,2,-2000,Chicago Bears,26,47.5,10000,2000,Tampa Bay Buccaneers,24,52.1,8000,-2000,https://www.espn.com/nfl/game?gameId=401547420
false,2,Sunday,Atlanta Falcons,17,3.4,1,0,Green Bay Packers,14,48.1,4500,0,Atlanta Falcons,13,51.5,4500,0,https://www.espn.com/nfl/game?gameId=401547417
false,2,Sunday,Cincinnati Bengals,8,3.3,1,-400,Baltimore Ravens,9,48.2,1800,400,Cincinnati Bengals,5,51.5,1400,-400,https://www.espn.com/nfl/game?gameId=401547412
false,3,Sunday,Dallas Cowboys,1,75.5,31,-28900,Dallas Cowboys,4,87.7,1100,-28900,Arizona Cardinals,30,12.2,30000,28900,https://www.espn.com/nfl/game?gameId=401547437
false,3,Thursday,San Francisco 49ers,3,57.6,24,-6300,New York Giants,22,21.1,7000,6300,San Francisco 49ers,2,78.7,700,-6300,https://www.espn.com/nfl/game?gameId=401547426
false,3,Sunday,Kansas City Chiefs,2,55.7,24,-9300,Chicago Bears,26,22.1,10000,9300,Kansas City Chiefs,0,77.8,700,-9300,https://www.espn.com/nfl/game?gameId=401547438
false,3,Sunday,Baltimore Ravens,7,52.6,23,-13200,Indianapolis Colts,29,23.6,15000,13200,Baltimore Ravens,9,76.2,1800,-13200,https://www.espn.com/nfl/game?gameId=401547427
false,3,Sunday,Buffalo Bills,4,46.7,21,-7000,Buffalo Bills,3,73.2,1000,-7000,Washington Commanders,25,26.5,8000,7000,https://www.espn.com/nfl/game?gameId=401547431
false,3,Sunday,Jacksonville Jaguars,12,46,19,-27800,Houston Texans,31,26.9,30000,27800,Jacksonville Jaguars,11,72.9,2200,-27800,https://www.espn.com/nfl/game?gameId=401547435
false,3,Monday,Philadelphia Eagles,5,45.2,23,-7300,Philadelphia Eagles,1,72.5,700,-7300,Tampa Bay Buccaneers,24,27.3,8000,7300,https://www.espn.com/nfl/game?gameId=401547440
false,3,Sunday,Seattle Seahawks,21,34,8,-5000,Carolina Panthers,28,32.9,10000,5000,Seattle Seahawks,16,66.9,5000,-5000,https://www.espn.com/nfl/game?gameId=401547432
false,3,Monday,Cincinnati Bengals,8,33.1,12,-4600,Los Angeles Rams,19,33.3,6000,4600,Cincinnati Bengals,5,66.4,1400,-4600,https://www.espn.com/nfl/game?gameId=401547441
false,3,Sunday,Miami Dolphins,6,29.1,8,-4400,Denver Broncos,17,35.3,6000,4400,Miami Dolphins,7,64.4,1600,-4400,https://www.espn.com/nfl/game?gameId=401547429
false,3,Sunday,Cleveland Browns,10,25.9,14,-8200,Tennessee Titans,27,36.9,10000,8200,Cleveland Browns,8,62.8,1800,-8200,https://www.espn.com/nfl/game?gameId=401547428
false,3,Sunday,Detroit Lions,11,17.5,6,-2900,Atlanta Falcons,13,41.1,4500,2900,Detroit Lions,6,58.6,1600,-2900,https://www.espn.com/nfl/game?gameId=401547433
false,3,Sunday,Las Vegas Raiders,22,12.9,1,-1000,Pittsburgh Steelers,23,43.4,7000,1000,Las Vegas Raiders,18,56.3,6000,-1000,https://www.espn.com/nfl/game?gameId=401547439
false,3,Sunday,New York Jets,13,12.3,5,-2000,New England Patriots,21,43.7,7000,2000,New York Jets,15,56,5000,-2000,https://www.espn.com/nfl/game?gameId=401547430
false,3,Sunday,Green Bay Packers,16,9.5,3,1500,New Orleans Saints,12,45.1,3000,-1500,Green Bay Packers,14,54.6,4500,1500,https://www.espn.com/nfl/game?gameId=401547434
false,3,Sunday,Los Angeles Chargers,9,9.1,6,-3800,Los Angeles Chargers,10,54.4,2200,-3800,Minnesota Vikings,20,45.3,6000,3800,https://www.espn.com/nfl/game?gameId=401547436
false,4,Sunday,San Francisco 49ers,3,79,29,-29300,Arizona Cardinals,30,10.5,30000,29300,San Francisco 49ers,2,89.5,700,-29300,https://www.espn.com/nfl/game?gameId=401547454
false,4,Sunday,Philadelphia Eagles,5,45.8,20,-7300,Washington Commanders,25,27,8000,7300,Philadelphia Eagles,1,72.8,700,-7300,https://www.espn.com/nfl/game?gameId=401547451
false,4,Sunday,Dallas Cowboys,1,43.7,17,-5900,New England Patriots,21,28,7000,5900,Dallas Cowboys,4,71.7,1100,-5900,https://www.espn.com/nfl/game?gameId=401547453
false,4,Sunday,Los Angeles Chargers,9,31.4,13,-3800,Las Vegas Raiders,18,34.2,6000,3800,Los Angeles Chargers,10,65.6,2200,-3800,https://www.espn.com/nfl/game?gameId=401547447
false,4,Sunday,Cincinnati Bengals,8,29.3,16,-8600,Cincinnati Bengals,5,64.5,1400,-8600,Tennessee Titans,27,35.2,10000,8600,https://www.espn.com/nfl/game?gameId=401547452
false,4,Sunday,Minnesota Vikings,15,27.1,14,-4000,Minnesota Vikings,20,63.4,6000,-4000,Carolina Panthers,28,36.3,10000,4000,https://www.espn.com/nfl/game?gameId=401547448
false,4,Sunday,New Orleans Saints,19,24.3,9,-5000,Tampa Bay Buccaneers,24,37.7,8000,5000,New Orleans Saints,12,62,3000,-5000,https://www.espn.com/nfl/game?gameId=401547450
false,4,Sunday,Kansas City Chiefs,2,22.1,11,-4300,Kansas City Chiefs,0,60.9,700,-4300,New York Jets,15,38.8,5000,4300,https://www.espn.com/nfl/game?gameId=401547455
false,4,Sunday,Denver Broncos,14,21.9,12,-4000,Denver Broncos,17,60.8,6000,-4000,Chicago Bears,26,38.9,10000,4000,https://www.espn.com/nfl/game?gameId=401547444
false,4,Sunday,Los Angeles Rams,20,17.5,10,-9000,Los Angeles Rams,19,58.6,6000,-9000,Indianapolis Colts,29,41.1,15000,9000,https://www.espn.com/nfl/game?gameId=401547449
false,4,Sunday,Pittsburgh Steelers,23,16.6,8,-23000,Pittsburgh Steelers,23,58.1,7000,-23000,Houston Texans,31,41.5,30000,23000,https://www.espn.com/nfl/game?gameId=401547446
false,4,Sunday,Jacksonville Jaguars,12,12.9,5,-2300,Atlanta Falcons,13,43.4,4500,2300,Jacksonville Jaguars,11,56.3,2200,-2300,https://www.espn.com/nfl/game?gameId=401547227
false,4,Sunday,Buffalo Bills,4,9.4,2,-600,Miami Dolphins,7,45.1,1600,600,Buffalo Bills,3,54.5,1000,-600,https://www.espn.com/nfl/game?gameId=401547443
false,4,Thursday,Detroit Lions,11,9.1,5,-2900,Detroit Lions,6,54.4,1600,-2900,Green Bay Packers,14,45.3,4500,2900,https://www.espn.com/nfl/game?gameId=401547442
false,4,Sunday,Baltimore Ravens,7,7.2,3,0,Baltimore Ravens,9,53.4,1800,0,Cleveland Browns,8,46.2,1800,0,https://www.espn.com/nfl/game?gameId=401547445
false,4,Monday,Seattle Seahawks,21,1,6,-2000,Seattle Seahawks,16,50.3,5000,-2000,New York Giants,22,49.3,7000,2000,https://www.espn.com/nfl/game?gameId=401547456
false,5,Sunday,Cincinnati Bengals,8,62.4,24,-28600,Cincinnati Bengals,5,81.1,1400,-28600,Arizona Cardinals,30,18.7,30000,28600,https://www.espn.com/nfl/game?gameId=401547466
false,5,Sunday,Miami Dolphins,6,51.8,21,-5400,New York Giants,22,24,7000,5400,Miami Dolphins,7,75.8,1600,-5400,https://www.espn.com/nfl/game?gameId=401547465
false,5,Sunday,Detroit Lions,11,45.4,18,-8400,Carolina Panthers,28,27.2,10000,8400,Detroit Lions,6,72.6,1600,-8400,https://www.espn.com/nfl/game?gameId=401547464
false,5,Sunday,Atlanta Falcons,17,33.7,14,-25500,Houston Texans,31,33,30000,25500,Atlanta Falcons,13,66.7,4500,-25500,https://www.espn.com/nfl/game?gameId=401547463
false,5,Sunday,Baltimore Ravens,7,28.6,16,-5200,Baltimore Ravens,9,64.2,1800,-5200,Pittsburgh Steelers,23,35.6,7000,5200,https://www.espn.com/nfl/game?gameId=401547460
false,5,Sunday,Kansas City Chiefs,2,28.5,13,-5300,Kansas City Chiefs,0,64.1,700,-5300,Minnesota Vikings,20,35.6,6000,5300,https://www.espn.com/nfl/game?gameId=401547462
false,5,Sunday,Buffalo Bills,4,21.7,8,-1200,Jacksonville Jaguars,11,39,2200,1200,Buffalo Bills,3,60.7,1000,-1200,https://www.espn.com/nfl/game?gameId=401547228
false,5,Sunday,Philadelphia Eagles,5,19.9,15,-5300,Philadelphia Eagles,1,59.8,700,-5300,Los Angeles Rams,19,39.9,6000,5300,https://www.espn.com/nfl/game?gameId=401547467
false,5,Sunday,Tennessee Titans,24,15.3,6,-5000,Tennessee Titans,27,57.5,10000,-5000,Indianapolis Colts,29,42.2,15000,5000,https://www.espn.com/nfl/game?gameId=401547458
false,5,Sunday,New England Patriots,18,7.4,1,4000,New Orleans Saints,12,46.1,3000,-4000,New England Patriots,21,53.5,7000,4000,https://www.espn.com/nfl/game?gameId=401547459
false,5,Sunday,Denver Broncos,14,5.7,1,1000,New York Jets,15,47,5000,-1000,Denver Broncos,17,52.7,6000,1000,https://www.espn.com/nfl/game?gameId=401547461
false,5,Thursday,Washington Commanders,25,5,1,-2000,Chicago Bears,26,47.3,10000,2000,Washington Commanders,25,52.3,8000,-2000,https://www.espn.com/nfl/game?gameId=401547457
false,5,Monday,Green Bay Packers,16,3.2,6,-1500,Green Bay Packers,14,51.4,4500,-1500,Las Vegas Raiders,18,48.2,6000,1500,https://www.espn.com/nfl/game?gameId=401547468
false,5,Sunday,San Francisco 49ers,3,2,2,-400,Dallas Cowboys,4,48.8,1100,400,San Francisco 49ers,2,50.8,700,-400,https://www.espn.com/nfl/game?gameId=401547354
false,6,Sunday,Miami Dolphins,6,55.3,23,-8400,Carolina Panthers,28,22.3,10000,8400,Miami Dolphins,7,77.6,1600,-8400,https://www.espn.com/nfl/game?gameId=401547473
false,6,Sunday,Los Angeles Rams,20,51.4,12,-24000,Arizona Cardinals,30,24.2,30000,24000,Los Angeles Rams,19,75.6,6000,-24000,https://www.espn.com/nfl/game?gameId=401547479
false,6,Sunday,Buffalo Bills,4,51.2,23,-6000,New York Giants,22,24.3,7000,6000,Buffalo Bills,3,75.5,1000,-6000,https://www.espn.com/nfl/game?gameId=401547481
false,6,Sunday,Jacksonville Jaguars,12,43.3,18,-12800,Indianapolis Colts,29,28.2,15000,12800,Jacksonville Jaguars,11,71.5,2200,-12800,https://www.espn.com/nfl/game?gameId=401547472
false,6,Sunday,Baltimore Ravens,7,35.6,17,-8200,Baltimore Ravens,9,67.7,1800,-8200,Tennessee Titans,27,32.1,10000,8200,https://www.espn.com/nfl/game?gameId=401547229
false,6,Thursday,Kansas City Chiefs,2,32.5,12,-5300,Denver Broncos,17,33.6,6000,5300,Kansas City Chiefs,0,66.1,700,-5300,https://www.espn.com/nfl/game?gameId=401547469
false,6,Sunday,Cincinnati Bengals,8,29.1,13,-3600,Seattle Seahawks,16,35.3,5000,3600,Cincinnati Bengals,5,64.4,1400,-3600,https://www.espn.com/nfl/game?gameId=401547471
false,6,Sunday,New Orleans Saints,19,25.1,12,-27000,New Orleans Saints,12,62.4,3000,-27000,Houston Texans,31,37.3,30000,27000,https://www.espn.com/nfl/game?gameId=401547477
false,6,Sunday,Detroit Lions,11,19.9,17,-6400,Detroit Lions,6,59.8,1600,-6400,Tampa Bay Buccaneers,24,39.9,8000,6400,https://www.espn.com/nfl/game?gameId=401547478
false,6,Sunday,Atlanta Falcons,17,18.7,8,-3500,Washington Commanders,25,40.5,8000,3500,Atlanta Falcons,13,59.2,4500,-3500,https://www.espn.com/nfl/game?gameId=401547470
false,6,Sunday,Minnesota Vikings,15,17.1,11,-4000,Minnesota Vikings,20,58.4,6000,-4000,Chicago Bears,26,41.3,10000,4000,https://www.espn.com/nfl/game?gameId=401547475
false,6,Sunday,Philadelphia Eagles,5,16.9,8,-4300,Philadelphia Eagles,1,58.3,700,-4300,New York Jets,15,41.4,5000,4300,https://www.espn.com/nfl/game?gameId=401547480
false,6,Sunday,Las Vegas Raiders,22,3.1,4,-1000,New England Patriots,21,48.3,7000,1000,Las Vegas Raiders,18,51.4,6000,-1000,https://www.espn.com/nfl/game?gameId=401547474
false,6,Sunday,San Francisco 49ers,3,0.8,7,-1100,San Francisco 49ers,2,50.2,700,-1100,Cleveland Browns,8,49.4,1800,1100,https://www.espn.com/nfl/game?gameId=401547476
false,6,Monday,Los Angeles Chargers,9,0.2,8,1100,Dallas Cowboys,4,49.7,1100,-1100,Los Angeles Chargers,10,49.9,2200,1100,https://www.espn.com/nfl/game?gameId=401547482
false,7,Sunday,Seattle Seahawks,21,51,11,-25000,Arizona Cardinals,30,24.4,30000,25000,Seattle Seahawks,16,75.4,5000,-25000,https://www.espn.com/nfl/game?gameId=401547493
false,7,Sunday,Cleveland Browns,10,38.3,20,-13200,Cleveland Browns,8,69,1800,-13200,Indianapolis Colts,29,30.7,15000,13200,https://www.espn.com/nfl/game?gameId=401547484
false,7,Sunday,Buffalo Bills,4,28.3,14,-6000,Buffalo Bills,3,64,1000,-6000,New England Patriots,21,35.7,7000,6000,https://www.espn.com/nfl/game?gameId=401547485
false,7,Sunday,Kansas City Chiefs,2,24.1,7,-1500,Los Angeles Chargers,10,37.8,2200,1500,Kansas City Chiefs,0,61.9,700,-1500,https://www.espn.com/nfl/game?gameId=401547488
false,7,Monday,San Francisco 49ers,3,21.9,12,-5300,San Francisco 49ers,2,60.8,700,-5300,Minnesota Vikings,20,38.9,6000,5300,https://www.espn.com/nfl/game?gameId=401547495
false,7,Sunday,Atlanta Falcons,17,17.5,11,-3500,Atlanta Falcons,13,58.6,4500,-3500,Tampa Bay Buccaneers,24,41.1,8000,3500,https://www.espn.com/nfl/game?gameId=401547491
false,7,Sunday,Baltimore Ravens,7,14.4,4,200,Detroit Lions,6,42.6,1600,-200,Baltimore Ravens,9,57,1800,200,https://www.espn.com/nfl/game?gameId=401547489
false,7,Thursday,Jacksonville Jaguars,12,10.3,7,-800,Jacksonville Jaguars,11,55,2200,-800,New Orleans Saints,12,44.7,3000,800,https://www.espn.com/nfl/game?gameId=401547483
false,7,Sunday,Denver Broncos,14,6.9,2,1500,Green Bay Packers,14,46.4,4500,-1500,Denver Broncos,17,53.3,6000,1500,https://www.espn.com/nfl/game?gameId=401547487
false,7,Sunday,Las Vegas Raiders,22,6.2,4,-4000,Las Vegas Raiders,18,52.9,6000,-4000,Chicago Bears,26,46.7,10000,4000,https://www.espn.com/nfl/game?gameId=401547490
false,7,Sunday,Los Angeles Rams,20,6.1,3,-1000,Pittsburgh Steelers,23,46.8,7000,1000,Los Angeles Rams,19,52.9,6000,-1000,https://www.espn.com/nfl/game?gameId=401547492
false,7,Sunday,Philadelphia Eagles,5,5.1,1,-900,Miami Dolphins,7,47.3,1600,900,Philadelphia Eagles,1,52.4,700,-900,https://www.espn.com/nfl/game?gameId=401547494
false,7,Sunday,New York Giants,27,0,2,-1000,Washington Commanders,25,49.8,8000,1000,New York Giants,22,49.8,7000,-1000,https://www.espn.com/nfl/game?gameId=401547486
false,8,Sunday,Baltimore Ravens,7,61.6,25,-28200,Baltimore Ravens,9,80.7,1800,-28200,Arizona Cardinals,30,19.1,30000,28200,https://www.espn.com/nfl/game?gameId=401547501
false,8,Thursday,Buffalo Bills,4,53.4,24,-7000,Tampa Bay Buccaneers,24,23.2,8000,7000,Buffalo Bills,3,76.6,1000,-7000,https://www.espn.com/nfl/game?gameId=401547496
false,8,Sunday,Dallas Cowboys,1,49.8,19,-4900,Los Angeles Rams,19,25,6000,4900,Dallas Cowboys,4,74.8,1100,-4900,https://www.espn.com/nfl/game?gameId=401547505
false,8,Sunday,Los Angeles Chargers,9,47.4,17,-7800,Chicago Bears,26,26.2,10000,7800,Los Angeles Chargers,10,73.6,2200,-7800,https://www.espn.com/nfl/game?gameId=401547510
false,8,Sunday,Philadelphia Eagles,5,41.6,20,-7300,Philadelphia Eagles,1,70.7,700,-7300,Washington Commanders,25,29.1,8000,7300,https://www.espn.com/nfl/game?gameId=401547508
false,8,Sunday,New York Jets,13,35.5,14,-2000,New York Jets,15,67.6,5000,-2000,New York Giants,22,32.1,7000,2000,https://www.espn.com/nfl/game?gameId=401547498
false,8,Sunday,Miami Dolphins,6,33.7,12,-5400,New England Patriots,21,33,7000,5400,Miami Dolphins,7,66.7,1600,-5400,https://www.espn.com/nfl/game?gameId=401547497
false,8,Monday,Detroit Lions,11,27,11,-4400,Las Vegas Raiders,18,36.4,6000,4400,Detroit Lions,6,63.4,1600,-4400,https://www.espn.com/nfl/game?gameId=401547511
false,8,Sunday,New Orleans Saints,19,25.1,11,-12000,New Orleans Saints,12,62.4,3000,-12000,Indianapolis Colts,29,37.3,15000,12000,https://www.espn.com/nfl/game?gameId=401547507
false,8,Sunday,Kansas City Chiefs,2,24.5,12,-5300,Kansas City Chiefs,0,62.1,700,-5300,Denver Broncos,17,37.6,6000,5300,https://www.espn.com/nfl/game?gameId=401547502
false,8,Sunday,Jacksonville Jaguars,12,18.5,11,-4800,Jacksonville Jaguars,11,59.1,2200,-4800,Pittsburgh Steelers,23,40.6,7000,4800,https://www.espn.com/nfl/game?gameId=401547499
false,8,Sunday,Cleveland Browns,10,10.5,11,-3200,Cleveland Browns,8,55.1,1800,-3200,Seattle Seahawks,16,44.6,5000,3200,https://www.espn.com/nfl/game?gameId=401547509
false,8,Sunday,San Francisco 49ers,3,8.8,5,-700,Cincinnati Bengals,5,45.4,1400,700,San Francisco 49ers,2,54.2,700,-700,https://www.espn.com/nfl/game?gameId=401547503
false,8,Sunday,Carolina Panthers,29,7.8,2,-20000,Houston Texans,31,45.9,30000,20000,Carolina Panthers,28,53.7,10000,-20000,https://www.espn.com/nfl/game?gameId=401547504
false,8,Sunday,Green Bay Packers,16,2.4,1,-1500,Minnesota Vikings,20,48.6,6000,1500,Green Bay Packers,14,51,4500,-1500,https://www.espn.com/nfl/game?gameId=401547506
false,8,Sunday,Tennessee Titans,24,0.6,7,5500,Atlanta Falcons,13,49.5,4500,-5500,Tennessee Titans,27,50.1,10000,5500,https://www.espn.com/nfl/game?gameId=401547500
false,9,Sunday,Cleveland Browns,10,66,22,-28200,Arizona Cardinals,30,16.9,30000,28200,Cleveland Browns,8,82.9,1800,-28200,https://www.espn.com/nfl/game?gameId=401547514
false,9,Sunday,Baltimore Ravens,7,37.7,14,-3200,Seattle Seahawks,16,31,5000,3200,Baltimore Ravens,9,68.7,1800,-3200,https://www.espn.com/nfl/game?gameId=401547513
false,9,Sunday,New Orleans Saints,19,22.9,7,-7000,Chicago Bears,26,38.4,10000,7000,New Orleans Saints,12,61.3,3000,-7000,https://www.espn.com/nfl/game?gameId=401547516
false,9,Sunday,Las Vegas Raiders,22,21.7,5,-1000,New York Giants,22,39,7000,1000,Las Vegas Raiders,18,60.7,6000,-1000,https://www.espn.com/nfl/game?gameId=401547521
false,9,Sunday,New England Patriots,18,20,7,-1000,Washington Commanders,25,39.8,8000,1000,New England Patriots,21,59.8,7000,-1000,https://www.espn.com/nfl/game?gameId=401547520
false,9,Sunday,Green Bay Packers,16,11.9,4,-1500,Los Angeles Rams,19,43.9,6000,1500,Green Bay Packers,14,55.8,4500,-1500,https://www.espn.com/nfl/game?gameId=401547519
false,9,Sunday,Buffalo Bills,4,8.5,4,-400,Buffalo Bills,3,54.1,1000,-400,Cincinnati Bengals,5,45.6,1400,400,https://www.espn.com/nfl/game?gameId=401547523
false,9,Sunday,Tampa Bay Buccaneers,28,7.3,3,-22000,Tampa Bay Buccaneers,24,53.5,8000,-22000,Houston Texans,31,46.2,30000,22000,https://www.espn.com/nfl/game?gameId=401547515
false,9,Thursday,Pittsburgh Steelers,23,7.2,1,-3000,Tennessee Titans,27,46.2,10000,3000,Pittsburgh Steelers,23,53.4,7000,-3000,https://www.espn.com/nfl/game?gameId=401547512
false,9,Sunday,Kansas City Chiefs,2,7,4,-900,Miami Dolphins,7,46.3,1600,900,Kansas City Chiefs,0,53.3,700,-900,https://www.espn.com/nfl/game?gameId=401547230
false,9,Sunday,Carolina Panthers,29,4.6,1,-5000,Indianapolis Colts,29,47.5,15000,5000,Carolina Panthers,28,52.1,10000,-5000,https://www.espn.com/nfl/game?gameId=401547517
false,9,Sunday,Dallas Cowboys,1,3.2,4,400,Dallas Cowboys,4,51.4,1100,400,Philadelphia Eagles,1,48.2,700,-400,https://www.espn.com/nfl/game?gameId=401547522
false,9,Monday,Los Angeles Chargers,9,2.2,4,-2800,Los Angeles Chargers,10,50.9,2200,-2800,New York Jets,15,48.7,5000,2800,https://www.espn.com/nfl/game?gameId=401547524
false,9,Sunday,Atlanta Falcons,17,1.8,2,-1500,Minnesota Vikings,20,48.9,6000,1500,Atlanta Falcons,13,50.7,4500,-1500,https://www.espn.com/nfl/game?gameId=401547518
false,10,Sunday,Dallas Cowboys,1,59,26,-5900,New York Giants,22,20.4,7000,5900,Dallas Cowboys,4,79.4,1100,-5900,https://www.espn.com/nfl/game?gameId=401547534
false,10,Sunday,Cincinnati Bengals,8,52.4,23,-28600,Houston Texans,31,23.7,30000,28600,Cincinnati Bengals,5,76.1,1400,-28600,https://www.espn.com/nfl/game?gameId=401547526
false,10,Sunday,Atlanta Falcons,17,44,15,-25500,Atlanta Falcons,13,71.9,4500,-25500,Arizona Cardinals,30,27.9,30000,25500,https://www.espn.com/nfl/game?gameId=401547529
false,10,Sunday,New England Patriots,18,29.4,12,-8000,Indianapolis Colts,29,35.2,15000,8000,New England Patriots,21,64.6,7000,-8000,https://www.espn.com/nfl/game?gameId=401547231
false,10,Monday,Buffalo Bills,4,21.7,10,-5000,Denver Broncos,17,39,6000,5000,Buffalo Bills,3,60.7,1000,-5000,https://www.espn.com/nfl/game?gameId=401547537
false,10,Sunday,Seattle Seahawks,21,21.5,4,-3000,Washington Commanders,25,39.1,8000,3000,Seattle Seahawks,16,60.6,5000,-3000,https://www.espn.com/nfl/game?gameId=401547535
false,10,Sunday,Baltimore Ravens,7,12.7,3,0,Cleveland Browns,8,43.5,1800,0,Baltimore Ravens,9,56.2,1800,0,https://www.espn.com/nfl/game?gameId=401547531
false,10,Thursday,Chicago Bears,26,11,3,0,Carolina Panthers,28,44.3,10000,0,Chicago Bears,26,55.3,10000,0,https://www.espn.com/nfl/game?gameId=401547525
false,10,Sunday,San Francisco 49ers,3,11,9,-1500,San Francisco 49ers,2,55.3,700,-1500,Jacksonville Jaguars,11,44.3,2200,1500,https://www.espn.com/nfl/game?gameId=401547532
false,10,Sunday,Minnesota Vikings,15,10.5,4,3000,New Orleans Saints,12,44.6,3000,-3000,Minnesota Vikings,20,55.1,6000,3000,https://www.espn.com/nfl/game?gameId=401547533
false,10,Sunday,Los Angeles Chargers,9,9.5,2,600,Detroit Lions,6,45.1,1600,-600,Los Angeles Chargers,10,54.6,2200,600,https://www.espn.com/nfl/game?gameId=401547530
false,10,Sunday,Tennessee Titans,24,9.2,4,2000,Tennessee Titans,27,54.4,10000,2000,Tampa Bay Buccaneers,24,45.2,8000,-2000,https://www.espn.com/nfl/game?gameId=401547528
false,10,Sunday,New York Jets,13,6,9,-1000,New York Jets,15,52.8,5000,-1000,Las Vegas Raiders,18,46.8,6000,1000,https://www.espn.com/nfl/game?gameId=401547536
false,10,Sunday,Green Bay Packers,16,2.2,7,-2500,Green Bay Packers,14,50.9,4500,-2500,Pittsburgh Steelers,23,48.7,7000,2500,https://www.espn.com/nfl/game?gameId=401547527
false,11,Sunday,San Francisco 49ers,3,58,25,-7300,Tampa Bay Buccaneers,24,20.9,8000,7300,San Francisco 49ers,2,78.9,700,-7300,https://www.espn.com/nfl/game?gameId=401547549
false,11,Sunday,Dallas Cowboys,1,51.4,28,-8900,Dallas Cowboys,4,75.6,1100,-8900,Carolina Panthers,28,24.2,10000,8900,https://www.espn.com/nfl/game?gameId=401547545
false,11,Sunday,Miami Dolphins,6,50.4,16,-4400,Las Vegas Raiders,18,24.7,6000,4400,Miami Dolphins,7,75.1,1600,-4400,https://www.espn.com/nfl/game?gameId=401547542
false,11,Sunday,Detroit Lions,11,31.1,15,-8400,Chicago Bears,26,34.3,10000,8400,Detroit Lions,6,65.4,1600,-8400,https://www.espn.com/nfl/game?gameId=401547546
false,11,Sunday,Houston Texans,31,29.5,1,0,Arizona Cardinals,30,35.1,30000,0,Houston Texans,31,64.6,30000,0,https://www.espn.com/nfl/game?gameId=401547540
false,11,Sunday,Jacksonville Jaguars,12,26.3,12,-7800,Tennessee Titans,27,36.7,10000,7800,Jacksonville Jaguars,11,63,2200,-7800,https://www.espn.com/nfl/game?gameId=401547541
false,11,Sunday,Cleveland Browns,10,23.3,13,-5200,Pittsburgh Steelers,23,38.2,7000,5200,Cleveland Browns,8,61.5,1800,-5200,https://www.espn.com/nfl/game?gameId=401547539
false,11,Sunday,Buffalo Bills,4,22.1,9,-4000,New York Jets,15,38.8,5000,4000,Buffalo Bills,3,60.9,1000,-4000,https://www.espn.com/nfl/game?gameId=401547543
false,11,Sunday,Los Angeles Rams,20,17.1,1,1000,Seattle Seahawks,16,41.3,5000,-1000,Los Angeles Rams,19,58.4,6000,1000,https://www.espn.com/nfl/game?gameId=401547544
false,11,Monday,Kansas City Chiefs,2,12.2,3,0,Philadelphia Eagles,1,43.7,700,0,Kansas City Chiefs,0,55.9,700,0,https://www.espn.com/nfl/game?gameId=401547345
false,11,Sunday,Los Angeles Chargers,9,11.8,7,-2300,Los Angeles Chargers,10,55.7,2200,-2300,Green Bay Packers,14,43.9,4500,2300,https://www.espn.com/nfl/game?gameId=401547547
false,11,Sunday,Washington Commanders,25,7,2,1000,New York Giants,22,46.3,7000,-1000,Washington Commanders,25,53.3,8000,1000,https://www.espn.com/nfl/game?gameId=401547548
false,11,Sunday,Denver Broncos,14,6.7,1,0,Minnesota Vikings,20,46.5,6000,0,Denver Broncos,17,53.2,6000,0,https://www.espn.com/nfl/game?gameId=401547550
false,11,Thursday,Baltimore Ravens,7,4.8,1,400,Cincinnati Bengals,5,47.4,1400,-400,Baltimore Ravens,9,52.2,1800,400,https://www.espn.com/nfl/game?gameId=401547538
false,12,Thursday,Dallas Cowboys,1,55.1,24,-6900,Washington Commanders,25,22.4,8000,6900,Dallas Cowboys,4,77.5,1100,-6900,https://www.espn.com/nfl/game?gameId=401547551
false,12,Sunday,Los Angeles Rams,20,45.3,12,-24000,Los Angeles Rams,19,72.5,6000,-24000,Arizona Cardinals,30,27.2,30000,24000,https://www.espn.com/nfl/game?gameId=401547562
false,12,Sunday,Jacksonville Jaguars,12,34.6,19,-27800,Jacksonville Jaguars,11,67.2,2200,-27800,Houston Texans,31,32.6,30000,27800,https://www.espn.com/nfl/game?gameId=401547555
false,12,Sunday,Cincinnati Bengals,8,34.4,15,-5600,Pittsburgh Steelers,23,32.7,7000,5600,Cincinnati Bengals,5,67.1,1400,-5600,https://www.espn.com/nfl/game?gameId=401547554
false,12,Sunday,Kansas City Chiefs,2,33.7,20,-5300,Kansas City Chiefs,0,66.7,700,-5300,Las Vegas Raiders,18,33,6000,5300,https://www.espn.com/nfl/game?gameId=401547557
false,12,Thursday,San Francisco 49ers,3,33.3,18,-4300,San Francisco 49ers,2,66.5,700,-4300,Seattle Seahawks,16,33.2,5000,4300,https://www.espn.com/nfl/game?gameId=401547553
false,12,Sunday,New England Patriots,18,26.9,9,0,New England Patriots,21,63.3,7000,0,New York Giants,22,36.4,7000,0,https://www.espn.com/nfl/game?gameId=401547560
false,12,Monday,Minnesota Vikings,15,24.7,11,-4000,Chicago Bears,26,37.5,10000,4000,Minnesota Vikings,20,62.2,6000,-4000,https://www.espn.com/nfl/game?gameId=401547565
false,12,Sunday,Tennessee Titans,24,17.5,5,0,Carolina Panthers,28,41.1,10000,0,Tennessee Titans,27,58.6,10000,0,https://www.espn.com/nfl/game?gameId=401547561
false,12,Thursday,Detroit Lions,11,13.6,5,-2900,Green Bay Packers,14,43,4500,2900,Detroit Lions,6,56.6,1600,-2900,https://www.espn.com/nfl/game?gameId=401547552
false,12,Friday,Miami Dolphins,6,12.6,7,-3400,Miami Dolphins,7,56.1,1600,-3400,New York Jets,15,43.5,5000,3400,https://www.espn.com/nfl/game?gameId=401547242
false,12,Sunday,Indianapolis Colts,30,7.1,2,7000,Tampa Bay Buccaneers,24,46.3,8000,-7000,Indianapolis Colts,29,53.4,15000,7000,https://www.espn.com/nfl/game?gameId=401547556
false,12,Sunday,Atlanta Falcons,17,5.3,2,1500,New Orleans Saints,12,47.2,3000,-1500,Atlanta Falcons,13,52.5,4500,1500,https://www.espn.com/nfl/game?gameId=401547559
false,12,Sunday,Los Angeles Chargers,9,4.4,2,400,Baltimore Ravens,9,47.6,1800,-400,Los Angeles Chargers,10,52,2200,400,https://www.espn.com/nfl/game?gameId=401547564
false,12,Sunday,Cleveland Browns,10,1.6,4,-4200,Cleveland Browns,8,50.6,1800,-4200,Denver Broncos,17,49,6000,4200,https://www.espn.com/nfl/game?gameId=401547563
false,12,Sunday,Buffalo Bills,4,0.6,1,300,Buffalo Bills,3,50.1,1000,300,Philadelphia Eagles,1,49.5,700,-300,https://www.espn.com/nfl/game?gameId=401547558
false,13,Thursday,Dallas Cowboys,1,47.9,20,-3900,Seattle Seahawks,16,25.9,5000,3900,Dallas Cowboys,4,73.8,1100,-3900,https://www.espn.com/nfl/game?gameId=401547566
false,13,Sunday,Pittsburgh Steelers,23,45.4,9,-23000,Arizona Cardinals,30,27.2,30000,23000,Pittsburgh Steelers,23,72.6,7000,-23000,https://www.espn.com/nfl/game?gameId=401547568
false,13,Sunday,Miami Dolphins,6,36.6,19,-6400,Miami Dolphins,7,68.2,1600,-6400,Washington Commanders,25,31.6,8000,6400,https://www.espn.com/nfl/game?gameId=401547574
false,13,Sunday,Denver Broncos,14,29.7,17,-24000,Denver Broncos,17,64.7,6000,-24000,Houston Texans,31,35,30000,24000,https://www.espn.com/nfl/game?gameId=401547571
false,13,Sunday,Kansas City Chiefs,2,23.9,14,-3800,Kansas City Chiefs,0,61.8,700,-3800,Green Bay Packers,14,37.9,4500,3800,https://www.espn.com/nfl/game?gameId=401547576
false,13,Sunday,Tennessee Titans,24,18.5,6,-5000,Indianapolis Colts,29,40.6,15000,5000,Tennessee Titans,27,59.1,10000,-5000,https://www.espn.com/nfl/game?gameId=401547570
false,13,Sunday,New York Jets,13,16.5,4,500,Atlanta Falcons,13,41.6,4500,-500,New York Jets,15,58.1,5000,500,https://www.espn.com/nfl/game?gameId=401547573
false,13,Sunday,Detroit Lions,11,13,8,-1400,Detroit Lions,6,56.3,1600,-1400,New Orleans Saints,12,43.3,3000,1400,https://www.espn.com/nfl/game?gameId=401547572
false,13,Sunday,Los Angeles Chargers,9,10.4,9,-4800,Los Angeles Chargers,10,55,2200,-4800,New England Patriots,21,44.6,7000,4800,https://www.espn.com/nfl/game?gameId=401547567
false,13,Sunday,Tampa Bay Buccaneers,28,8.3,1,-2000,Carolina Panthers,28,45.7,10000,2000,Tampa Bay Buccaneers,24,54,8000,-2000,https://www.espn.com/nfl/game?gameId=401547569
false,13,Sunday,Cleveland Browns,10,7.6,10,-4200,Cleveland Browns,8,53.6,1800,-4200,Los Angeles Rams,19,46,6000,4200,https://www.espn.com/nfl/game?gameId=401547575
false,13,Monday,Cincinnati Bengals,8,6.6,4,-800,Cincinnati Bengals,5,53.1,1400,-800,Jacksonville Jaguars,11,46.5,2200,800,https://www.espn.com/nfl/game?gameId=401547577
false,13,Sunday,Philadelphia Eagles,5,2.6,2,0,San Francisco 49ers,2,48.5,700,0,Philadelphia Eagles,1,51.1,700,0,https://www.espn.com/nfl/game?gameId=401547276
false,14,Sunday,Cincinnati Bengals,8,46.8,22,-13600,Indianapolis Colts,29,26.5,15000,13600,Cincinnati Bengals,5,73.3,1400,-13600,https://www.espn.com/nfl/game?gameId=401547580
false,14,Sunday,New York Jets,13,43.3,18,-25000,Houston Texans,31,28.2,30000,25000,New York Jets,15,71.5,5000,-25000,https://www.espn.com/nfl/game?gameId=401547582
false,14,Sunday,Baltimore Ravens,7,42.6,13,-4200,Los Angeles Rams,19,28.6,6000,4200,Baltimore Ravens,9,71.2,1800,-4200,https://www.espn.com/nfl/game?gameId=401547585
false,14,Monday,Miami Dolphins,6,42.2,18,-8400,Tennessee Titans,27,28.8,10000,8400,Miami Dolphins,7,71,1600,-8400,https://www.espn.com/nfl/game?gameId=401547592
false,14,Sunday,San Francisco 49ers,3,38,18,-4300,Seattle Seahawks,16,30.9,5000,4300,San Francisco 49ers,2,68.9,700,-4300,https://www.espn.com/nfl/game?gameId=401547589
false,14,Sunday,New Orleans Saints,19,27.1,10,-7000,Carolina Panthers,28,36.3,10000,7000,New Orleans Saints,12,63.4,3000,-7000,https://www.espn.com/nfl/game?gameId=401547587
false,14,Sunday,Atlanta Falcons,17,24.5,11,-3500,Tampa Bay Buccaneers,24,37.6,8000,3500,Atlanta Falcons,13,62.1,4500,-3500,https://www.espn.com/nfl/game?gameId=401547579
false,14,Sunday,Detroit Lions,11,22.1,15,-8400,Detroit Lions,6,60.9,1600,-8400,Chicago Bears,26,38.8,10000,8400,https://www.espn.com/nfl/game?gameId=401547586
false,14,Sunday,Los Angeles Chargers,9,19.1,5,-3800,Denver Broncos,17,40.3,6000,3800,Los Angeles Chargers,10,59.4,2200,-3800,https://www.espn.com/nfl/game?gameId=401547584
false,14,Sunday,Dallas Cowboys,1,18.9,4,400,Philadelphia Eagles,1,40.4,700,-400,Dallas Cowboys,4,59.3,1100,400,https://www.espn.com/nfl/game?gameId=401547590
false,14,Monday,Green Bay Packers,16,10.4,11,-2500,Green Bay Packers,14,55,4500,-2500,New York Giants,22,44.6,7000,2500,https://www.espn.com/nfl/game?gameId=401547591
false,14,Sunday,Cleveland Browns,10,9,2,-400,Jacksonville Jaguars,11,45.3,2200,400,Cleveland Browns,8,54.3,1800,-400,https://www.espn.com/nfl/game?gameId=401547581
false,14,Thursday,New England Patriots,18,3.2,5,0,New England Patriots,21,51.4,7000,0,Pittsburgh Steelers,23,48.2,7000,0,https://www.espn.com/nfl/game?gameId=401547578
false,14,Sunday,Minnesota Vikings,15,2.8,7,0,Minnesota Vikings,20,51.2,6000,0,Las Vegas Raiders,18,48.4,6000,0,https://www.espn.com/nfl/game?gameId=401547588
false,14,Sunday,Buffalo Bills,4,0.6,2,300,Buffalo Bills,3,50.1,1000,300,Kansas City Chiefs,0,49.5,700,-300,https://www.espn.com/nfl/game?gameId=401547583
false,15,Sunday,San Francisco 49ers,3,59.7,29,-29300,San Francisco 49ers,2,79.8,700,-29300,Arizona Cardinals,30,20.1,30000,29300,https://www.espn.com/nfl/game?gameId=401547596
false,15,Sunday,Cleveland Browns,10,35.4,16,-8200,Chicago Bears,26,32.2,10000,8200,Cleveland Browns,8,67.6,1800,-8200,https://www.espn.com/nfl/game?gameId=401547605
false,15,Sunday,Green Bay Packers,16,27.5,12,-3500,Tampa Bay Buccaneers,24,36.1,8000,3500,Green Bay Packers,14,63.6,4500,-3500,https://www.espn.com/nfl/game?gameId=401547598
false,15,Sunday,New Orleans Saints,19,26.9,8,-4000,New York Giants,22,36.4,7000,4000,New Orleans Saints,12,63.3,3000,-4000,https://www.espn.com/nfl/game?gameId=401547599
false,15,Thursday,Los Angeles Chargers,9,25.7,13,-3800,Los Angeles Chargers,10,62.7,2200,-3800,Las Vegas Raiders,18,37,6000,3800,https://www.espn.com/nfl/game?gameId=401547593
false,15,Sunday,Philadelphia Eagles,5,23.5,16,-4300,Philadelphia Eagles,1,61.6,700,-4300,Seattle Seahawks,16,38.1,5000,4300,https://www.espn.com/nfl/game?gameId=401547601
false,15,Monday,Kansas City Chiefs,2,23.5,16,-6300,Kansas City Chiefs,0,61.6,700,-6300,New England Patriots,21,38.1,7000,6300,https://www.espn.com/nfl/game?gameId=401547608
false,15,Sunday,Cincinnati Bengals,8,23.1,7,-4600,Minnesota Vikings,20,38.3,6000,4600,Cincinnati Bengals,5,61.4,1400,-4600,https://www.espn.com/nfl/game?gameId=401547604
false,15,Sunday,Atlanta Falcons,17,22.7,12,-5500,Atlanta Falcons,13,61.2,4500,-5500,Carolina Panthers,28,38.5,10000,5500,https://www.espn.com/nfl/game?gameId=401547603
false,15,Sunday,Miami Dolphins,6,21.3,7,-3400,New York Jets,15,39.2,5000,3400,Miami Dolphins,7,60.5,1600,-3400,https://www.espn.com/nfl/game?gameId=401547594
false,15,Sunday,Pittsburgh Steelers,23,20.3,7,-8000,Pittsburgh Steelers,23,60,7000,-8000,Indianapolis Colts,29,39.7,15000,8000,https://www.espn.com/nfl/game?gameId=401547607
false,15,Sunday,Tennessee Titans,24,18.6,7,-20000,Houston Texans,31,40.5,30000,20000,Tennessee Titans,27,59.1,10000,-20000,https://www.espn.com/nfl/game?gameId=401547595
false,15,Sunday,Los Angeles Rams,20,14.3,5,-2000,Washington Commanders,25,42.7,8000,2000,Los Angeles Rams,19,57,6000,-2000,https://www.espn.com/nfl/game?gameId=401547597
false,15,Sunday,Detroit Lions,11,11.9,3,-4400,Denver Broncos,17,43.9,6000,4400,Detroit Lions,6,55.8,1600,-4400,https://www.espn.com/nfl/game?gameId=401547606
false,15,Sunday,Baltimore Ravens,7,8.7,5,-400,Baltimore Ravens,9,54.2,1800,-400,Jacksonville Jaguars,11,45.5,2200,400,https://www.espn.com/nfl/game?gameId=401547602
false,15,Sunday,Dallas Cowboys,1,1.2,3,100,Dallas Cowboys,4,50.4,1100,100,Buffalo Bills,3,49.2,1000,-100,https://www.espn.com/nfl/game?gameId=401547600
false,16,Monday,Philadelphia Eagles,5,49,22,-6300,New York Giants,22,25.4,7000,6300,Philadelphia Eagles,1,74.4,700,-6300,https://www.espn.com/nfl/game?gameId=401547241
false,16,Monday,Kansas City Chiefs,2,40.4,20,-5300,Las Vegas Raiders,18,29.7,6000,5300,Kansas City Chiefs,0,70.1,700,-5300,https://www.espn.com/nfl/game?gameId=401547351
false,16,Sunday,Cleveland Browns,10,35.7,21,-28200,Cleveland Browns,8,67.7,1800,-28200,Houston Texans,31,32,30000,28200,https://www.espn.com/nfl/game?gameId=401547612
false,16,Sunday,Chicago Bears,26,33.7,6,-20000,Arizona Cardinals,30,33,30000,20000,Chicago Bears,26,66.7,10000,-20000,https://www.espn.com/nfl/game?gameId=401547619
false,16,Sunday,Atlanta Falcons,17,30.3,13,-10500,Indianapolis Colts,29,34.7,15000,10500,Atlanta Falcons,13,65,4500,-10500,https://www.espn.com/nfl/game?gameId=401547616
false,16,Sunday,Jacksonville Jaguars,12,28.4,16,-5800,Jacksonville Jaguars,11,64.1,2200,-5800,Tampa Bay Buccaneers,24,35.7,8000,5800,https://www.espn.com/nfl/game?gameId=401547615
false,16,Sunday,New York Jets,13,27.9,12,-3000,Washington Commanders,25,35.9,8000,3000,New York Jets,15,63.8,5000,-3000,https://www.espn.com/nfl/game?gameId=401547613
false,16,Saturday,Cincinnati Bengals,8,25.1,15,-5600,Cincinnati Bengals,5,62.4,1400,-5600,Pittsburgh Steelers,23,37.3,7000,5600,https://www.espn.com/nfl/game?gameId=401547610
false,16,Sunday,Green Bay Packers,16,21.9,13,-5500,Green Bay Packers,14,60.8,4500,-5500,Carolina Panthers,28,38.9,10000,5500,https://www.espn.com/nfl/game?gameId=401547617
false,16,Monday,San Francisco 49ers,3,19.3,4,-1100,Baltimore Ravens,9,40.2,1800,1100,San Francisco 49ers,2,59.5,700,-1100,https://www.espn.com/nfl/game?gameId=401547622
false,16,Sunday,Denver Broncos,14,17,4,-1000,New England Patriots,21,41.3,7000,1000,Denver Broncos,17,58.3,6000,-1000,https://www.espn.com/nfl/game?gameId=401547621
false,16,Thursday,Los Angeles Rams,20,6.8,1,3000,New Orleans Saints,12,46.4,3000,-3000,Los Angeles Rams,19,53.2,6000,3000,https://www.espn.com/nfl/game?gameId=401547609
false,16,Sunday,Detroit Lions,11,6.4,4,-4400,Detroit Lions,6,53,1600,-4400,Minnesota Vikings,20,46.6,6000,4400,https://www.espn.com/nfl/game?gameId=401547618
false,16,Sunday,Dallas Cowboys,1,3.8,5,-500,Dallas Cowboys,4,51.7,1100,-500,Miami Dolphins,7,47.9,1600,500,https://www.espn.com/nfl/game?gameId=401547620
false,16,Saturday,Los Angeles Chargers,9,3.6,5,1200,Buffalo Bills,3,48,1000,-1200,Los Angeles Chargers,10,51.6,2200,1200,https://www.espn.com/nfl/game?gameId=401547611
false,16,Sunday,Tennessee Titans,24,2.6,3,5000,Seattle Seahawks,16,48.5,5000,-5000,Tennessee Titans,27,51.1,10000,5000,https://www.espn.com/nfl/game?gameId=401547614
false,17,Sunday,Philadelphia Eagles,5,69.9,27,-29300,Arizona Cardinals,30,15,30000,29300,Philadelphia Eagles,1,84.9,700,-29300,https://www.espn.com/nfl/game?gameId=401547633
false,17,Sunday,Jacksonville Jaguars,12,36.6,17,-7800,Carolina Panthers,28,31.6,10000,7800,Jacksonville Jaguars,11,68.2,2200,-7800,https://www.espn.com/nfl/game?gameId=401547629
false,17,Sunday,San Francisco 49ers,3,34.7,22,-7300,San Francisco 49ers,2,67.2,700,-7300,Washington Commanders,25,32.5,8000,7300,https://www.espn.com/nfl/game?gameId=401547635
false,17,Sunday,Buffalo Bills,4,33.2,14,-6000,New England Patriots,21,33.3,7000,6000,Buffalo Bills,3,66.5,1000,-6000,https://www.espn.com/nfl/game?gameId=401547626
false,17,Saturday,Dallas Cowboys,1,29.5,10,-500,Detroit Lions,6,35.1,1600,500,Dallas Cowboys,4,64.6,1100,-500,https://www.espn.com/nfl/game?gameId=401547624
false,17,Sunday,New Orleans Saints,19,18.9,9,-5000,New Orleans Saints,12,59.3,3000,-5000,Tampa Bay Buccaneers,24,40.4,8000,5000,https://www.espn.com/nfl/game?gameId=401547634
false,17,Sunday,Atlanta Falcons,17,16.2,9,-5500,Atlanta Falcons,13,57.9,4500,-5500,Chicago Bears,26,41.7,10000,5500,https://www.espn.com/nfl/game?gameId=401547627
false,17,Sunday,Los Angeles Rams,20,13.7,7,-1000,Los Angeles Rams,19,56.7,6000,-1000,New York Giants,22,43,7000,1000,https://www.espn.com/nfl/game?gameId=401547632
false,17,Sunday,Kansas City Chiefs,2,12.5,6,-700,Cincinnati Bengals,5,43.6,1400,700,Kansas City Chiefs,0,56.1,700,-700,https://www.espn.com/nfl/game?gameId=401547235
false,17,Sunday,Tennessee Titans,24,11.2,7,-20000,Tennessee Titans,27,55.4,10000,-20000,Houston Texans,31,44.2,30000,20000,https://www.espn.com/nfl/game?gameId=401547631
false,17,Sunday,Los Angeles Chargers,9,9.9,5,-3800,Los Angeles Chargers,10,54.8,2200,-3800,Denver Broncos,17,44.9,6000,3800,https://www.espn.com/nfl/game?gameId=401547630
false,17,Sunday,Las Vegas Raiders,22,9.3,8,-9000,Las Vegas Raiders,18,54.5,6000,-9000,Indianapolis Colts,29,45.2,15000,9000,https://www.espn.com/nfl/game?gameId=401547628
false,17,Sunday,Seattle Seahawks,21,9,2,-2000,Pittsburgh Steelers,23,45.3,7000,2000,Seattle Seahawks,16,54.3,5000,-2000,https://www.espn.com/nfl/game?gameId=401547636
false,17,Thursday,Cleveland Browns,10,6.9,3,-3200,New York Jets,15,46.4,5000,3200,Cleveland Browns,8,53.3,1800,-3200,https://www.espn.com/nfl/game?gameId=401547623
false,17,Sunday,Minnesota Vikings,15,2.2,1,1500,Green Bay Packers,14,48.7,4500,-1500,Minnesota Vikings,20,50.9,6000,1500,https://www.espn.com/nfl/game?gameId=401547637
false,17,Sunday,Baltimore Ravens,7,0.2,1,200,Miami Dolphins,7,49.7,1600,-200,Baltimore Ravens,9,49.9,1800,200,https://www.espn.com/nfl/game?gameId=401547625
false,18,Sunday,Philadelphia Eagles,5,45.8,22,-6300,Philadelphia Eagles,1,72.8,700,-6300,New York Giants,22,27,7000,6300,https://www.espn.com/nfl/game?gameId=401547650
false,18,Sunday,Dallas Cowboys,1,44.2,24,-6900,Dallas Cowboys,4,72,1100,-6900,Washington Commanders,25,27.8,8000,6900,https://www.espn.com/nfl/game?gameId=401547653
false,18,Sunday,San Francisco 49ers,3,37.3,17,-5300,Los Angeles Rams,19,31.2,6000,5300,San Francisco 49ers,2,68.5,700,-5300,https://www.espn.com/nfl/game?gameId=401547651
false,18,Sunday,Seattle Seahawks,21,33.3,11,-25000,Seattle Seahawks,16,66.5,5000,-25000,Arizona Cardinals,30,33.2,30000,25000,https://www.espn.com/nfl/game?gameId=401547638
false,18,Sunday,Baltimore Ravens,7,32.3,16,-5200,Pittsburgh Steelers,23,33.7,7000,5200,Baltimore Ravens,9,66,1800,-5200,https://www.espn.com/nfl/game?gameId=401547639
false,18,Sunday,Green Bay Packers,16,23.9,10,-5500,Chicago Bears,26,37.9,10000,5500,Green Bay Packers,14,61.8,4500,-5500,https://www.espn.com/nfl/game?gameId=401547643
false,18,Sunday,Jacksonville Jaguars,12,18.9,12,-7800,Jacksonville Jaguars,11,59.3,2200,-7800,Tennessee Titans,27,40.4,10000,7800,https://www.espn.com/nfl/game?gameId=401547652
false,18,Sunday,Detroit Lions,11,15.4,4,-4400,Minnesota Vikings,20,42.1,6000,4400,Detroit Lions,6,57.5,1600,-4400,https://www.espn.com/nfl/game?gameId=401547642
false,18,Sunday,New York Jets,13,11.6,5,-2000,New York Jets,15,55.6,5000,-2000,New England Patriots,21,44,7000,2000,https://www.espn.com/nfl/game?gameId=401547648
false,18,Sunday,Denver Broncos,14,11.5,8,0,Denver Broncos,17,55.6,6000,0,Las Vegas Raiders,18,44.1,6000,0,https://www.espn.com/nfl/game?gameId=401547646
false,18,Sunday,Cincinnati Bengals,8,6,2,-400,Cleveland Browns,8,46.8,1800,400,Cincinnati Bengals,5,52.8,1400,-400,https://www.espn.com/nfl/game?gameId=401547641
false,18,Sunday,Indianapolis Colts,30,5.6,1,-15000,Houston Texans,31,47,30000,15000,Indianapolis Colts,29,52.6,15000,-15000,https://www.espn.com/nfl/game?gameId=401547644
false,18,Sunday,Kansas City Chiefs,2,5.4,7,-1500,Kansas City Chiefs,0,52.5,700,-1500,Los Angeles Chargers,10,47.1,2200,1500,https://www.espn.com/nfl/game?gameId=401547645
false,18,Sunday,Miami Dolphins,6,4,2,600,Buffalo Bills,3,47.8,1000,-600,Miami Dolphins,7,51.8,1600,600,https://www.espn.com/nfl/game?gameId=401547647
false,18,Sunday,New Orleans Saints,19,0.6,2,-1500,Atlanta Falcons,13,49.5,4500,1500,New Orleans Saints,12,50.1,3000,-1500,https://www.espn.com/nfl/game?gameId=401547649
false,18,Sunday,Carolina Panthers,29,0.6,1,2000,Tampa Bay Buccaneers,24,49.5,8000,-2000,Carolina Panthers,28,50.1,10000,2000,https://www.espn.com/nfl/game?gameId=401547640